type octile
height 46
width 47
map
@@TTTTTTTTTTTTTTTTTTTTTTTTTTTT@@@@@@@@@@@@@@@@@
@T............................T@@@@@@@@@@@@@@@@
@T............................T@@@@@@@@@@@@@@@@
@T............................T@@@@@@@@@@@@@@@@
@T............................T@@@@@@@@@@@@@@@@
@T............................T@@@@@@@@@@@@@@@@
@T............................T@@@@@@@@@@@@@@@@
@T............................T@@@@@@@@@@@@@@@@
@T............................T@@@@@@@@@@@@@@@@
@T............................T@@@@@@@@@@@@@@@@
@T............................T@@@@@@@@@@@@@@@@
@@TTT.........................T@@@@@@@@@@@@@@@@
@@@@@TT.......................T@@@@@@@@@@@@@@@@
@@@@@@@TT.....................T@@@@@@@@@@@@@@@@
@@@@@@@@@TT...................T@@@@@@@@@@@@@@@@
@@@@@@@@@@T...................T@@@@@@@@@@@@@@@@
@@@@@@@@@@@TT.................T@@@@@@@@@@@@@@@@
@@@@@@@@@@@@@T............TTTT@@@@@@@@@@@@@@@@@
@@@@@@@@@@@@@@T...........T@@@@@@@@@@@@@@@@@@@@
@@@@@@@@@@@@@@@T.........T@@@@@@@@@@@@@@@@@@@@@
@@@@@@@@@@@@@@@@T.........T@@@@@@@@@@@@@@@@@@@@
@@@@@@@@@@@@@@@@@T....TTTT@@@@@@@@@@@@@@@@@@@@@
@@@@@@@@@@@@@@@@@T....T@@@@@@@@@@@@@@@@@@@@@@@@
@@@@@@@@@@@@@@@@@T....T@@@@@@@@@@@@@@@@@@@@@@@@
@@@@@@@@@@@@@@@@@T....TTT@@@@@@@@@@@@@@@@@@@@@@
@@@@@@@@@@@@@@@@T........T@@@@@@@@@@@@@@@@@@@@@
@@@@@@@@@@@@@@@@T........T@@@@@@@@@@@@@@@@@@@@@
@@@@@@@@@@@@@@@@T........T@@@@@@@@@@@@@@@@@@@@@
@@@T@@@@@@@@@@@T..........T@@@@@@@@@@@@@@@@@@@@
@@T.TT@@@@@@@@@T...........T@@@@@@@@@@@@@@@@@@@
@T....T@@@@@@@@T............TT@@@@@@@@@@@@@@@@@
@T.....T@@@@@TT...............T@@@@@@@@@@@@@@@@
@T......T@@@T.................T@@TTTTTTTTTTTTT@
T........TTT...................TT.............T
T.............................................T
T.............................................T
T..............................TT.............T
@T............................T@@T............T
@T............................T@@T............T
@T......................TTT...T@@T............T
@T......................T@T.TT@@@T............T
@T......................T@T.T@@@@T............T
@@@@@@@TTT..............T@T.T@@@@@TT..TT......T
@@@@@@@@@@TT@@TTTTTTT...T@T.T@@@@@@T..T@TTT...T
@@@@@@@@@@@@@@@@@@@@T...T@T.T@@@@@@T..T@@T....T
@@@@@@@@@@@@@@@@@@@@@TTT@@@T@@@@@@@@TT@@@@TTTT@
